10	10
9	3	0	7
	2	2	2	2	2	2	2	16	2	2
	2	12	5	5	9	12	3	1	9	2
	2	11	6	8	1	7	5	1	10	2
	2	12	1	10	8	5	6	8	9	2
	2	11	1	5	1	6	8	1	6	2
	2	15	6	8	1	7	1	1	10	2
	2	12	10	14	11	9	8	6	16	2
	2	8	5	5	5	1	10	11	6	2
	2	11	7	1	10	11	3	3	10	2
	2	2	2	14	2	2	2	2	2	2