10	10

9	3	0	7
	
	2	2	2	2	2	2	2	16	2	2
	
	2	12	5	5	5	5	5	6	16	2
	
	2	8	1	1	1	1	1	1	6	2
	
	2	8	1	1	1	1	1	1	6	2
	
	2	8	1	1	1	1	1	1	6	2
	
	2	8	1	1	1	1	1	1	6	2
	
	2	8	1	1	1	1	1	1	6	2
	
	2	8	1	1	1	1	1	1	6	2
	
	2	11	7	1	7	7	7	7	10	2
	
	2	2	2	14	2	2	2	2	2	2